0,0,0,0,0,0,0,0,0,0,0,0
0,0,0,0,0,0,0,0,0,0,0,0
0,0,0,0,0,0,0,0,0,0,0,0
0,0,0,0,0,0,0,0,0,0,0,0
0,0,0,0,0,0,0,0,0,0,0,0
0,0,0,0,0,0,0,0,0,0,0,0 
0,0,0,0,0,0,0,0,0,0,0,0
,,,,,,,,,,,0
﻿0,0,0,0,0,0,0,0,0,0,0,0
0,2,0,0,2,0,0,2,0,0,2,0
0,0,0,0,0,0,0,0,0,0,0,0
0,2,0,0,2,0,0,2,0,0,2,0
0,0,0,0,0,5,5,0,0,0,0,0
0,2,0,5,2,5,5,2,5,0,2,0
0,0,0,5,5,5,5,5,5,0,0,0
,,,,,,,,,,,1
0,0,0,0,0,0,0,0,0,0,0,0
0,0,0,0,0,0,0,0,0,0,0,0
0,0,0,0,0,0,0,0,0,0,0,0
0,0,0,0,0,0,0,0,0,0,0,0
0,0,0,0,0,0,0,0,0,0,0,0
0,0,0,0,0,0,0,0,0,0,0,0
0,0,0,0,0,0,0,0,0,0,0,0
,,,,,,,,,,,2
0,0,0,0,0,0,0,0,0,0,0,0
0,0,0,0,0,0,0,0,0,0,0,0
0,0,1,1,0,0,0,0,1,1,0,0
0,0,1,1,0,0,0,0,1,1,0,0
0,0,1,1,0,0,0,0,1,1,0,0
0,0,0,0,0,0,0,0,0,0,0,0
0,0,0,0,0,0,0,0,0,0,0,0
,,,,,,,,,,,3
0,0,0,0,0,0,0,0,0,0,0,0
0,0,0,0,0,0,0,0,0,0,0,0
0,0,0,0,0,1,1,0,0,0,0,0
0,0,0,0,0,1,1,0,0,0,0,0
0,0,0,0,0,1,1,0,0,0,0,0
0,0,0,0,0,0,0,0,0,0,0,0
0,0,0,0,0,0,0,0,0,0,0,0
,,,,,,,,,,,4
0,0,0,0,0,0,0,0,0,0,0,0
0,0,0,0,0,0,0,0,0,0,0,0
0,0,1,0,0,0,0,0,0,1,0,0
0,0,0,0,0,0,0,0,0,0,0,0
0,0,1,0,0,0,0,0,0,1,0,0
0,0,0,0,0,0,0,0,0,0,0,0
0,0,0,0,0,0,0,0,0,0,0,0
,,,,,,,,,,,5
0,0,0,0,0,0,0,0,0,0,0,0
0,0,0,0,0,0,0,0,0,0,0,0
0,0,0,0,0,1,1,0,0,0,0,0
0,0,0,0,0,1,1,0,0,0,0,0
0,0,0,0,0,1,1,0,0,0,0,0
0,0,0,0,0,0,0,0,0,0,0,0
0,0,0,0,0,0,0,0,0,0,0,0
,,,,,,,,,,,6
0,0,0,0,0,0,0,0,0,0,0,0
0,0,1,0,0,0,0,0,0,1,0,0
0,0,0,0,0,0,0,0,0,0,0,0
0,0,0,0,0,0,0,0,0,0,0,0
0,0,0,0,0,0,0,0,0,0,0,0
0,0,1,0,0,0,0,0,0,1,0,0
0,0,0,0,0,0,0,0,0,0,0,0
,,,,,,,,,,,7
0,0,0,0,0,0,0,0,0,0,0,0
0,0,0,0,0,0,0,0,0,0,0,0
0,0,0,0,0,0,0,0,0,0,0,0
0,0,0,0,0,0,0,0,0,0,0,0
0,0,0,0,0,0,0,0,0,0,0,0
0,0,0,0,0,0,0,0,0,0,0,0
0,0,0,0,0,0,0,0,0,0,0,0
,,,,,,,,,,,8
0,0,0,0,0,0,0,0,0,0,0,0
0,0,0,0,0,0,0,0,0,0,0,0
0,0,0,0,0,0,0,0,0,0,0,0
0,0,0,0,0,0,0,0,0,0,0,0
0,0,0,0,0,0,0,0,0,0,0,0
0,0,0,0,0,0,0,0,0,0,0,0
0,0,0,0,0,0,0,0,0,0,0,0
,,,,,,,,,,,9
0,0,0,0,0,0,0,0,0,0,0,0
0,1,1,0,0,0,0,0,0,1,1,0
0,0,0,0,0,0,0,0,0,0,0,0
0,0,0,0,0,1,1,0,0,0,0,0
0,0,0,0,0,0,0,0,0,0,0,0
0,1,1,0,0,0,0,0,0,1,1,0
0,0,0,0,0,0,0,0,0,0,0,0
,,,,,,,,,,,10
0,0,0,0,0,0,0,0,0,0,0,0
0,0,0,0,0,0,0,0,0,0,0,0
0,0,1,0,0,0,0,0,0,1,0,0
0,0,0,0,0,0,0,0,0,0,0,0
0,0,1,0,0,0,0,0,0,1,0,0
0,0,0,0,0,0,0,0,0,0,0,0
0,0,0,0,0,0,0,0,0,0,0,0
,,,,,,,,,,,11
﻿3,3,3,3,3,0,0,3,3,3,3,3
3,0,0,0,3,0,0,0,0,3,0,3
3,0,3,0,3,0,3,3,0,3,0,3
0,0,3,0,3,0,0,3,0,3,0,0
3,0,3,0,3,3,0,3,0,3,0,3
3,0,3,0,0,0,0,3,0,0,0,3
3,3,3,3,3,0,0,3,3,3,3,3
,,,,,,,,,,,12
0,0,0,0,0,0,0,0,0,0,0,0
0,3,3,3,0,0,0,0,3,3,3,0
0,3,0,0,0,0,0,0,0,0,3,0
0,3,0,3,3,3,3,3,3,0,3,0
0,3,0,0,0,0,0,0,0,0,3,0
0,3,3,3,0,0,0,0,3,3,3,0
0,0,0,0,0,0,0,0,0,0,0,0
,,,,,,,,,,,13
0,0,0,0,0,0,0,0,0,0,0,0
0,0,0,0,0,0,1,0,0,0,0,0
0,0,0,0,0,1,0,1,0,0,0,0
0,0,0,0,0,0,4,0,1,0,0,0
0,0,0,0,0,1,0,1,0,0,0,0
0,0,0,0,0,0,1,0,0,0,0,0
0,0,0,0,0,0,0,0,0,0,0,0
,,,,,,,,,,,14
0,0,0,0,0,0,0,0,0,0,0,0
0,1,0,1,0,1,1,0,1,0,1,0
0,0,0,0,0,0,0,0,0,0,0,0
0,1,0,1,0,1,1,0,1,0,1,0
0,0,0,0,0,0,0,0,0,0,0,0
0,1,0,1,0,1,1,0,1,0,1,0
0,0,0,0,0,0,0,0,0,0,0,0
,,,,,,,,,,,15
0,0,0,0,0,0,0,1,1,1,1,1
0,0,0,0,0,0,0,0,0,1,1,1
0,0,0,0,0,0,0,0,0,0,1,1
0,0,0,0,0,0,0,0,0,0,0,0
0,0,0,0,0,0,0,0,0,0,1,1
0,0,0,0,0,0,0,0,0,1,1,1
0,0,0,0,0,0,0,1,1,1,1,1
,,,,,,,,,,,16
0,0,0,0,0,0,0,0,0,0,0,0
0,1,1,1,1,1,1,1,1,1,1,0
0,1,0,0,2,0,0,2,0,0,1,0
0,1,0,2,0,0,0,0,2,0,1,0
0,1,0,0,0,0,0,0,0,0,1,0
0,1,1,1,1,0,0,1,1,1,1,0
0,0,0,0,0,0,0,0,0,0,0,0